5 5 5 5 5 5 5 5 5 5 5 5 5 5 5 5 5 5 5 5 5 5 5 5 5 5 10 10 10 10 10 10 10 10 10 10 10 10 10 10 10 10 10 10 10 10 10 10 10 10
5 5 5 5 5 5 5 5 5 5 5 5 5 5 5 5 5 5 5 5 5 5 5 5 5 5 10 10 10 10 10 10 10 10 10 10 10 10 10 10 10 10 10 10 10 10 10 10 10 10
5 5 5 5 5 5 5 5 5 5 5 5 5 5 5 5 5 5 5 5 5 5 5 5 5 5 10 10 10 10 10 10 10 10 10 10 10 10 10 10 10 10 10 10 10 10 10 10 10 10
5 5 5 5 5 5 5 5 5 5 5 5 5 5 5 5 5 5 5 5 5 5 5 0 0 0 0 10 10 10 10 10 10 10 10 10 10 10 10 10 10 10 10 10 10 10 10 10 10 10
5 5 5 5 5 5 5 5 5 5 5 5 5 5 5 5 5 5 5 5 5 0 0 0 0 0 0 10 10 10 10 10 10 10 10 10 10 10 10 10 10 10 10 10 10 10 10 10 10 10
5 5 5 5 5 5 5 5 5 5 5 5 0 0 0 0 0 0 0 0 0 0 0 0 0 0 0 0 10 10 10 10 10 10 10 10 10 10 10 10 10 10 10 10 10 10 10 10 10 10
5 5 5 5 5 5 5 5 5 5 0 0 0 0 0 0 0 0 0 0 0 0 0 0 0 0 0 0 10 10 10 10 10 10 10 10 10 10 10 10 10 10 10 10 10 10 10 10 10 10
5 5 5 5 5 5 5 5 0 0 0 0 0 0 0 0 0 0 0 0 0 0 0 0 0 0 0 0 0 10 10 10 10 10 10 10 10 10 10 10 10 10 10 10 10 10 10 10 10 10
5 5 5 5 5 5 5 0 0 8 0 0 0 0 0 0 0 0 0 0 8 0 0 0 0 0 0 0 0 10 10 10 10 10 10 10 10 10 10 10 10 10 10 10 10 10 10 10 10 10
5 5 5 5 5 5 0 0 8 8 8 0 0 0 0 0 0 0 0 8 8 8 0 0 0 0 0 0 0 0 10 10 10 10 10 10 10 10 10 10 10 10 10 10 10 10 10 10 10 10
5 5 5 5 5 0 0 0 8 8 8 8 8 8 8 8 8 8 8 8 8 8 0 0 0 0 0 0 0 0 10 10 10 10 10 10 10 10 10 10 10 10 10 10 10 10 10 10 10 10
5 5 5 5 0 0 0 0 0 8 8 9 9 9 9 9 9 9 9 8 8 0 5 0 5 0 0 0 0 0 0 10 10 10 10 10 10 10 10 10 10 10 10 10 10 10 10 10 10 10
5 5 5 0 0 5 5 0 0 0 8 9 9 9 9 9 9 9 9 8 0 0 5 5 5 0 0 1 7 2 0 10 10 10 10 10 10 10 10 10 10 10 10 10 10 10 10 10 10 10
5 5 5 0 0 5 5 5 5 0 8 9 9 9 9 9 9 9 9 8 0 5 5 5 5 5 0 1 7 2 0 0 0 10 10 10 10 10 10 10 10 10 10 10 10 10 10 10 10 10
5 5 5 0 5 5 5 5 5 0 8 9 9 9 9 9 9 9 9 8 0 5 5 5 5 5 0 1 7 2 0 0 0 0 10 10 10 10 10 10 10 10 10 10 10 10 10 10 10 10
5 5 5 0 5 5 5 5 5 0 8 9 9 9 9 9 9 9 9 8 0 0 5 5 5 5 0 1 7 2 0 0 0 0 0 0 10 10 10 10 10 10 10 10 10 10 10 10 10 10
5 5 5 0 5 5 5 5 0 0 8 9 9 9 9 9 9 9 9 8 0 5 5 5 5 5 0 1 7 2 0 0 0 0 0 0 0 0 0 10 10 10 10 10 10 10 10 10 10 10
5 5 5 0 5 5 5 5 0 0 8 9 9 9 9 9 9 9 9 8 0 0 5 5 5 0 0 1 7 2 0 0 0 0 0 0 0 0 0 0 0 10 10 10 10 10 10 10 10 10
5 5 5 0 0 5 5 0 0 0 8 9 9 9 9 9 9 9 9 8 0 0 5 5 5 0 1 7 2 0 0 0 0 0 0 0 0 0 0 0 0 0 0 10 10 10 10 10 10 10
5 5 5 0 0 0 0 0 0 8 8 9 9 9 9 9 9 9 9 8 8 0 0 0 5 0 1 7 2 0 0 0 0 0 0 0 0 0 0 0 0 0 0 0 10 10 10 10 10 10
5 5 0 0 0 0 0 0 8 8 8 8 8 8 11 11 8 8 8 8 8 8 0 0 0 0 1 7 2 0 0 0 0 0 0 5 0 0 5 0 0 0 0 0 0 10 10 10 10 10
5 5 0 0 0 0 0 0 8 8 8 0 0 5 9 9 5 0 0 8 8 8 0 0 0 0 1 7 2 0 0 0 0 0 5 5 0 5 5 0 5 5 0 0 0 10 10 10 10 10
5 5 0 0 5 0 0 0 0 8 0 0 0 0 9 9 0 0 0 0 8 0 0 0 0 0 1 7 2 0 0 0 5 5 5 5 0 5 5 0 5 5 0 0 0 0 10 10 10 10
5 5 0 0 5 5 5 5 0 0 0 0 0 1 7 7 2 0 0 0 0 0 0 0 0 1 7 2 0 0 0 0 0 5 5 5 0 5 5 0 5 5 5 0 0 0 0 10 10 10
5 5 0 0 5 5 5 5 0 0 0 0 0 1 7 6 2 0 5 5 0 5 5 0 0 1 7 2 0 0 0 5 5 5 0 0 0 0 0 0 0 0 5 5 0 0 0 0 10 10
5 5 0 0 5 5 5 5 0 0 0 0 0 1 7 7 2 0 5 5 5 5 5 0 0 1 7 2 0 0 0 0 0 0 0 5 5 5 5 5 0 0 0 5 0 0 0 0 0 10
5 5 0 0 5 5 5 5 5 5 0 0 0 1 7 7 2 0 5 5 5 5 5 5 0 1 7 2 0 0 0 0 0 5 5 5 5 5 5 5 5 0 0 0 0 0 0 0 0 5
5 5 5 0 0 5 5 5 5 5 0 0 0 1 7 7 2 0 0 0 5 5 5 5 0 1 7 2 0 0 0 0 5 5 5 5 5 5 5 5 5 5 0 0 0 0 0 0 0 5
5 5 5 0 0 0 0 5 5 5 0 0 0 1 7 7 2 0 0 5 5 5 0 0 0 1 7 2 0 0 0 5 5 8 8 7 7 7 8 7 8 5 5 0 0 0 0 0 0 5
5 5 5 5 0 0 0 0 5 5 0 0 0 1 7 7 2 0 0 5 0 0 0 0 0 1 7 2 0 0 5 5 5 7 7 7 9 9 7 9 7 5 5 0 0 0 0 0 5 5
5 5 5 5 0 0 0 0 0 0 0 0 0 1 7 7 2 0 0 0 0 0 0 0 0 1 7 2 0 0 5 5 5 8 9 6 9 7 9 7 8 5 5 0 0 0 0 0 5 5
5 5 5 5 0 0 0 0 5 5 0 0 0 1 7 7 2 0 0 0 0 0 5 5 0 1 7 2 0 0 0 5 5 8 7 9 9 7 7 9 8 5 5 5 0 0 0 0 5 5
5 5 5 5 0 0 5 5 5 5 5 0 0 1 6 7 2 0 5 5 0 5 5 5 0 1 7 2 0 0 5 5 5 8 7 9 9 9 9 9 8 5 5 5 0 0 0 0 5 5
5 5 5 5 0 0 5 5 5 5 5 0 0 1 7 7 2 0 5 5 0 5 5 0 0 1 7 2 0 0 5 5 5 8 9 9 9 7 9 6 8 5 5 5 0 0 0 0 5 5
5 5 5 5 0 0 5 5 5 5 5 0 0 1 7 7 2 0 5 5 5 5 5 0 1 7 2 0 0 0 0 5 5 8 7 8 8 11 8 8 8 5 5 5 0 0 0 5 5 5
5 5 5 5 5 0 5 5 5 5 5 0 0 1 7 7 2 0 5 5 5 5 5 5 1 7 2 0 0 0 0 5 5 5 5 5 5 7 2 0 0 0 5 0 0 0 0 5 5 5
5 5 5 5 5 0 0 5 5 5 5 0 0 1 7 7 2 0 0 5 5 5 5 5 1 7 2 0 5 0 0 0 5 5 5 5 5 7 2 0 0 0 0 0 0 0 0 5 5 5
5 5 5 5 5 0 0 5 5 5 5 0 0 1 7 7 2 0 5 5 5 5 5 5 1 7 2 0 5 5 5 0 0 0 0 5 1 7 2 0 0 0 0 0 0 0 0 5 5 5
5 5 5 5 5 0 0 5 5 5 5 5 0 1 7 7 2 0 5 5 5 5 5 5 1 7 2 0 5 5 5 5 0 0 0 0 1 7 2 0 0 5 5 5 0 0 0 5 5 5
5 5 5 5 5 0 0 0 5 5 5 5 0 1 7 6 2 0 5 5 5 5 5 0 1 7 2 0 5 5 5 5 5 5 0 0 1 6 2 0 5 5 5 5 0 0 5 5 5 5
5 5 5 5 5 5 0 0 0 5 5 5 0 1 7 7 2 0 5 5 5 5 5 5 1 7 2 0 5 5 5 5 5 5 0 0 1 7 2 0 5 5 5 5 0 0 5 5 5 5
5 5 5 5 5 5 0 0 0 0 0 5 0 1 7 7 2 5 5 5 5 5 5 5 1 7 2 0 0 5 5 5 5 5 0 0 1 7 2 0 5 5 5 5 0 0 5 5 5 5
5 5 5 5 5 5 5 0 0 0 0 0 0 1 7 7 2 0 0 5 0 5 5 0 1 7 2 0 0 0 0 0 0 0 0 0 1 7 2 0 0 5 5 5 0 0 5 5 5 5
5 5 5 5 5 5 5 0 0 0 0 0 0 1 7 7 7 3 3 3 3 3 3 3 6 7 7 3 3 3 3 3 3 3 3 3 3 7 2 0 0 5 5 0 0 0 5 5 5 5
5 5 5 5 5 5 5 5 5 0 0 0 0 1 7 7 7 7 6 7 7 7 7 7 7 7 7 7 7 7 7 7 6 7 7 7 7 7 2 0 0 0 0 0 0 5 5 5 5 5
5 5 5 5 5 5 5 5 5 5 0 0 0 1 4 4 4 4 4 4 4 4 4 4 7 7 7 4 4 4 4 4 4 4 4 4 4 4 2 0 0 0 0 5 5 5 5 5 5 5
5 5 5 5 5 5 5 5 5 5 5 0 0 0 0 0 0 0 0 0 0 0 0 0 1 7 2 0 0 0 0 0 0 0 0 0 0 0 0 0 0 5 5 5 5 5 5 5 5 5
5 5 5 5 5 5 5 5 5 5 5 5 5 5 0 0 0 0 0 0 0 0 0 0 1 7 2 0 0 0 0 0 0 0 0 0 0 0 0 5 5 5 5 5 5 5 5 5 5 5
5 5 5 5 5 5 5 5 5 5 5 5 5 5 5 5 5 5 5 0 0 0 0 0 1 7 2 0 0 0 0 0 0 0 5 5 5 5 5 5 5 5 5 5 5 5 5 5 5 5
5 5 5 5 5 5 5 5 5 5 5 5 5 5 5 5 5 5 5 5 5 5 5 5 1 6 2 5 5 5 5 5 5 5 5 5 5 5 5 5 5 5 5 5 5 5 5 5 5 5