10 10 10 10 10 10 10 10 10 10 10 10 10 10 10 10 10 10 10 10 10 10 10 10 10 10 10 10 10 10 10 10 10 10 10 10 10 10 10 10 10 10 10 10 10 10 10 10 10 10
10 10 10 10 10 10 10 10 10 10 10 10 10 10 10 10 10 10 10 10 10 10 10 10 10 10 10 10 10 10 10 10 10 10 10 10 10 10 10 10 10 10 10 10 10 10 10 10 10 10
10 10 10 10 10 10 10 10 10 10 10 10 10 10 10 10 10 10 10 10 10 10 10 10 10 10 10 10 10 10 10 10 10 10 10 10 10 10 10 10 10 10 10 10 10 10 10 10 10 10
10 10 10 10 10 10 10 10 10 10 10 10 10 10 10 10 10 10 10 10 10 10 10 10 10 10 10 10 10 10 10 10 10 10 10 10 10 10 10 10 10 10 10 10 10 10 10 10 10 10
10 10 10 10 10 10 10 10 10 10 10 10 28 26 26 26 26 26 26 26 29 10 10 10 10 10 10 10 10 10 10 10 10 10 10 10 10 10 10 10 10 10 10 10 10 10 10 10 10 10
10 10 10 10 10 10 10 10 10 10 28 26 27 11 11 11 11 11 11 11 25 26 26 26 26 26 26 29 10 10 10 10 10 10 28 26 26 26 26 26 26 26 26 29 10 10 10 10 10 10
10 10 10 10 10 10 10 10 10 28 27 11 11 8 8 8 8 8 8 8 8 11 11 5 5 5 5 25 26 26 26 26 26 26 27 5 5 5 11 11 11 11 11 25 26 29 10 10 10 10
10 10 10 10 10 10 10 10 28 27 11 11 11 8 9 9 9 9 9 9 8 11 11 5 5 5 5 5 5 5 5 5 5 5 5 5 5 5 11 11 11 11 11 11 11 23 10 10 10 10
10 10 10 10 10 10 10 10 24 11 11 11 11 8 9 9 9 9 9 9 8 11 11 5 5 5 5 5 5 5 5 5 5 5 5 5 5 11 11 11 19 18 11 11 11 25 29 10 10 10
10 10 10 10 10 10 10 10 24 11 11 11 11 8 9 9 9 9 9 9 8 11 11 5 5 5 5 5 5 5 5 5 5 5 5 5 11 11 11 11 1 2 11 11 11 11 23 10 10 10
10 10 10 10 10 10 10 10 30 22 11 11 11 8 9 9 9 9 9 9 8 11 5 5 5 5 5 5 5 5 5 5 5 5 11 11 11 11 11 0 1 2 11 11 11 11 23 10 10 10
10 10 10 10 10 10 10 10 10 30 21 22 11 8 8 8 9 9 8 8 8 11 5 5 5 5 5 5 5 5 5 5 5 11 11 19 3 3 3 3 35 2 11 11 11 20 31 10 10 10
10 10 10 10 10 10 10 10 10 10 10 30 22 11 11 1 7 7 2 11 11 11 5 5 5 5 5 5 5 5 5 5 5 11 0 1 32 4 4 4 4 17 11 11 20 31 10 10 10 10
10 10 10 10 10 10 10 10 10 10 10 10 24 11 11 1 7 7 2 11 11 11 5 5 5 5 5 5 5 5 5 5 5 11 11 1 2 11 11 11 11 11 11 20 31 10 10 10 10 10
10 10 10 10 10 10 10 10 10 10 10 10 30 21 22 1 7 7 2 11 11 5 5 5 5 5 5 5 5 5 5 5 11 11 11 1 2 11 11 11 11 11 20 31 10 10 10 10 10 10
10 10 10 10 10 10 10 10 10 10 10 10 10 10 24 1 6 7 2 11 5 5 5 5 5 5 5 5 5 5 5 5 11 11 11 1 2 11 11 5 5 20 31 10 10 10 10 10 10 10
10 10 10 10 10 10 10 10 10 10 10 10 10 28 27 16 33 32 17 11 5 5 5 5 5 5 5 5 5 5 5 11 0 11 11 1 2 11 5 5 5 25 29 10 10 10 10 10 10 10
10 10 10 10 10 10 10 10 10 10 10 10 28 27 5 11 1 2 11 11 5 5 5 5 5 5 11 11 11 11 11 11 11 11 11 1 2 11 5 5 5 5 23 10 10 10 10 10 10 10
10 10 10 10 10 10 10 10 10 28 26 26 27 5 5 11 1 2 11 0 5 5 5 5 5 5 11 19 3 3 3 3 3 3 3 35 2 11 5 5 5 5 23 10 10 10 10 10 10 10
10 10 10 10 10 10 10 10 28 27 5 5 5 5 5 11 1 2 11 11 5 5 5 5 5 5 11 1 32 4 4 4 4 4 4 4 17 11 5 5 5 5 23 10 10 10 10 10 10 10
10 10 10 10 10 28 26 26 27 5 5 5 5 5 5 11 1 2 11 11 5 5 5 5 5 11 11 1 2 11 11 11 11 11 11 0 11 11 5 5 5 5 25 29 10 10 10 10 10 10
10 10 10 10 28 27 11 5 5 5 5 5 5 5 5 11 1 2 11 11 11 5 5 5 5 11 11 1 2 11 11 11 11 11 11 11 5 5 5 5 5 5 5 23 10 10 10 10 10 10
10 10 10 28 27 11 11 11 11 11 5 5 5 5 11 11 1 2 11 11 11 5 5 5 5 11 11 1 2 0 11 11 11 5 5 5 5 5 5 5 5 5 5 23 10 10 10 10 10 10
10 10 10 24 11 11 11 11 11 0 11 11 11 11 19 3 35 2 11 11 11 11 11 11 11 11 11 1 2 11 11 11 11 5 5 5 5 5 5 5 5 5 5 25 29 10 10 10 10 10
10 10 10 24 11 19 3 3 3 3 3 3 3 3 35 32 33 2 11 11 11 11 11 11 11 11 11 1 2 0 11 11 5 5 5 5 5 5 5 5 5 5 5 5 23 10 10 10 10 10
10 10 10 24 11 16 4 4 4 4 4 4 4 4 4 17 1 34 3 3 3 3 3 3 3 3 3 35 2 11 11 11 5 5 5 5 5 5 5 5 5 5 5 5 23 10 10 10 10 10
10 10 10 24 11 11 11 5 5 5 5 5 5 11 11 11 16 4 4 4 4 4 4 4 4 4 4 33 2 11 11 11 5 5 5 5 5 5 5 5 5 5 5 5 23 10 10 10 10 10
10 10 10 30 22 11 11 5 5 5 5 5 5 5 5 11 11 11 11 11 11 11 0 11 11 11 0 1 2 11 11 11 5 5 5 5 5 5 5 5 5 5 5 5 25 29 10 10 10 10 
10 10 10 10 24 5 5 5 5 5 5 5 5 5 5 5 5 5 5 11 11 11 11 11 11 11 11 1 2 11 11 5 5 5 5 5 5 5 5 5 5 5 5 5 5 23 10 10 10 10
10 10 10 10 30 22 5 5 5 5 5 5 5 5 5 5 5 5 5 5 5 5 11 11 11 11 11 1 2 11 11 5 5 5 5 5 5 5 5 5 5 5 5 5 5 23 10 10 10 10 
10 10 10 10 10 30 22 5 5 5 5 5 5 5 5 5 5 5 5 5 5 5 5 11 11 11 11 1 2 11 5 5 5 5 5 5 5 5 5 5 5 5 5 5 5 23 10 10 10 10
10 10 10 10 10 10 30 22 5 5 5 5 5 5 5 5 5 5 5 5 5 5 5 5 11 11 11 1 2 11 5 5 5 5 5 5 5 5 5 5 5 5 5 5 5 23 10 10 10 10
10 10 10 10 10 10 10 24 5 5 5 5 5 5 5 5 5 5 5 5 5 5 5 5 5 11 11 1 2 11 5 5 5 5 5 5 5 5 5 5 5 5 5 5 5 23 10 10 10 10
10 10 10 10 10 10 10 24 5 5 5 5 5 5 5 5 5 5 5 5 5 5 5 5 5 11 11 1 2 0 11 5 5 5 5 5 5 5 5 5 5 5 5 5 5 23 10 10 10 10
10 10 10 10 10 10 28 27 5 5 5 5 5 5 5 5 5 5 5 5 5 5 5 5 5 11 11 1 2 11 11 5 5 5 5 5 5 5 5 5 5 5 5 5 20 31 10 10 10 10
10 10 10 10 10 10 24 5 5 5 5 5 5 5 5 5 5 5 5 5 5 5 5 5 5 11 11 1 2 11 11 11 5 5 5 5 5 5 5 5 5 5 5 20 31 10 10 10 10 10
10 10 10 10 10 28 27 5 5 5 5 5 5 5 5 5 5 5 5 5 5 5 5 5 5 0 11 1 2 11 11 11 5 5 5 5 5 5 5 5 5 5 20 31 10 10 10 10 10 10 
10 10 10 10 10 24 5 5 5 5 5 5 5 5 5 5 5 5 5 5 5 5 5 5 5 11 11 1 2 11 11 11 11 11 5 5 5 5 5 5 5 20 31 10 10 10 10 10 10 10
10 10 10 10 10 24 5 5 5 5 5 5 5 5 5 5 5 5 5 5 5 5 5 5 5 11 11 1 34 3 18 11 11 11 11 5 5 5 5 5 5 25 29 10 10 10 10 10 10 10
10 10 10 10 10 24 5 5 5 5 5 5 5 5 5 5 5 5 5 5 5 5 5 5 5 5 11 16 4 33 2 11 11 11 11 5 5 5 5 5 5 5 23 10 10 10 10 10 10 10
10 10 10 10 10 24 5 5 5 5 5 5 5 5 5 5 5 5 5 5 5 5 5 5 5 5 11 11 11 1 2 11 11 11 5 5 8 8 8 8 8 5 23 10 10 10 10 10 10 10
10 10 10 10 10 30 22 5 5 5 5 5 5 5 5 5 5 5 5 5 5 5 5 5 5 5 5 11 11 1 34 3 3 3 3 8 6 9 9 9 8 5 23 10 10 10 10 10 10 10
10 10 10 10 10 10 30 22 5 5 5 5 5 5 5 5 5 5 5 5 5 5 5 5 5 5 5 5 11 1 7 7 7 7 6 7 9 7 9 7 8 5 23 10 10 10 10 10 10 10
10 10 10 10 10 10 10 24 5 5 5 5 5 5 5 5 5 5 5 5 5 5 5 5 5 5 5 5 11 16 4 4 4 4 4 8 7 9 7 6 8 5 23 10 10 10 10 10 10 10
10 10 10 10 10 10 10 30 21 21 21 21 21 21 21 21 21 21 21 21 21 21 21 21 21 22 5 5 11 11 11 11 11 11 11 5 8 8 8 8 8 5 23 10 10 10 10 10 10 10
10 10 10 10 10 10 10 10 10 10 10 10 10 10 10 10 10 10 10 10 10 10 10 10 10 30 21 21 22 11 11 11 11 11 11 5 5 5 5 5 5 20 31 10 10 10 10 10 10 10
10 10 10 10 10 10 10 10 10 10 10 10 10 10 10 10 10 10 10 10 10 10 10 10 10 10 10 10 30 21 21 21 21 21 21 21 21 21 21 21 21 31 10 10 10 10 10 10 10 10
10 10 10 10 10 10 10 10 10 10 10 10 10 10 10 10 10 10 10 10 10 10 10 10 10 10 10 10 10 10 10 10 10 10 10 10 10 10 10 10 10 10 10 10 10 10 10 10 10 10
10 10 10 10 10 10 10 10 10 10 10 10 10 10 10 10 10 10 10 10 10 10 10 10 10 10 10 10 10 10 10 10 10 10 10 10 10 10 10 10 10 10 10 10 10 10 10 10 10 10
10 10 10 10 10 10 10 10 10 10 10 10 10 10 10 10 10 10 10 10 10 10 10 10 10 10 10 10 10 10 10 10 10 10 10 10 10 10 10 10 10 10 10 10 10 10 10 10 10 10